NO ./no.xpm  
SO ./so.xpm  
WE ./we.xpm  
EA ./ea.xpm  
F 186,164,138    
C 135,206,253


11111111111111111111111
100000000000000000000001
100000000000000000000001
100000001000000000000001
100000010100000000000001
100000010100000000000001
100000010100000000000001
100000010100000000000001
100000010100000000000001
10000000000W000000000001
111111111111111111111111