NO ./no.xpm  
SO ./so.xpm  
WE ./we.xpm  
EA ./ea.xpm  
F 186,164,138    
C 135,206,253


11111111111111111111111
100000000000000000100001
100111111111111110101001
10W000000000010000101001
110100000011110000101111
100111111010000000100001
101000000010111000111101
101111111110000000000001
100000000010000000000001
100000100010000000000001
111111111111111111111111