
NO     img/wall1.xpm

SO      img/wall4.xpm

WE img/wall2.xpm

EA img/wall3.xpm

F 71,74,81
C 220,220,220


1111111111111111111111111111111111111
1000000000000000000000000000000000001
1000000000000000000000000000000000001
1000000000000000000000000000000000001
1000000000000W00000000000000000000001
1000000000000000000000000000000000001
1000000000000000000000000000000000001
1000000000000000000000000000000000001
1000000000000000000000000000000000001
1000000000000000000000000000000000001
1000000000000000000000000000000000001
1000000000000000000000000000000000001
1000000000000000000000000000000000001
1111111111111111111111111111111111111