NO ./Wall1.xpm 
SO ./Wall2.xpm
WE ./Wall3.xpm
EA ./Wall4.xpm  
F 186,164,138    
C 135,206,253

1111111111111111111111111111111111111111
     1111111110000000000000000001111111   
        1010110000011100000000000111111
11111111111110111000000100011111111
11111111000001111100N00010001
       1000001 100000001100011111111
    11110000111101000000000011111
11111111111111111100111111111
1111111111111111100111111111
10000000111100010000000001001
100000001  100110101010000001
100000001 1110000001110100001
111111111 1111111111111111111